###########
#.V..#..H.#
#.##...##.#
#L#..#..R.#
#.#.###.#.#
#....@....#
###########
