####################
###.....L..........#
###.##.##.##L##.##.#
###.##.##.##.##.##.#
#.L................#
#.##.##.##.##.##.###
#.##.##L##.##.##.###
#.................L#
#.#.#.#J####J#.#.#.#
#L.................#
###.##.##.##.##.##.#
###.##.##R##.##.##.#
#................R.#
#.##.##.##.##R##.###
#.##.##.##.##.##.###
#@....R..........###
####################
